0  0  0  0  0  0  0  0  0  0  0  0  0  0  0  0  6  0  0  0  0  0  0  0  0  0  0  0  0  0  0  0  
0  0  0  0  0  0  0  0  0  0  0  0  0  0  0  0  0  0  0  0  0  0  0  0  0  0  0  0  0  0  0  0  
0  0  0  0  0  0  0  0  0  0  22 0  0  0  0  0  0  0  0  0  0  0  0  0  0  0  8  8  8  8  3  0  
0  0  0  0  0  0  0  0  0  0  0  0  23 0  0  0  0  0  0  0  0  0  0  0  0  0  0  0  0  0  3  0  
0  0  0  0  0  0  0  0  0  0  0  3  8  8  8  8  8  8  8  8  8  3  0  0  0  0  0  0  0  0  3  0  
0  0  0  0  0  0  0  0  0  0  0  3  0  0  0  0  0  0  0  0  0  3  8  8  8  8  8  8  8  8  3  0  
0  0  0  0  0  0  0  0  0  0  0  3  0  0  0  0  0  0  0  0  0  3  0  0  0  0  0  0  0  0  0  0  
1  1  1  1  1  1  3  0  0  0  0  3  0  0  0  0  0  0  0  0  0  3  0  0  0  0  0  0  0  0  0  0  
0  0  0  0  0  0  3  0  0  0  0  3  0  0  0  0  0  0  0  0  0  3  0  0  0  0  0  0  0  0  0  0  
0  0  0  0  0  0  3  8  8  8  0  3  0  0  0  0  0  3  8  8  8  1  1  1  1  1  1  1  1  1  3  0  
0  0  0  0  0  0  3  0  0  0  0  3  0  0  0  0  0  3  0  0  0  0  0  0  0  0  0  0  0  0  3  0  
0  0  0  0  0  0  0  0  0  8  0  8  8  8  8  8  8  3  0  0  0  0  0  0  0  0  0  0  0  0  3  0  
1  8  8  8  1  8  8  1  8  8  8  8  0  0  0  0  0  3  0  0  0  0  3  8  8  8  8  3  8  8  8  8  
1  8  8  8  1  0  0  0  0  0  0  3  0  0  0  0  0  3  0  0  0  0  3  0  0  0  0  3  0  0  0  0  
1  0  0  0  1  0  0  0  0  0  0  3  0  0  0  0  0  3  2  2  2  2  3  0  0  0  0  3  0  0  0  0  
8  8  8  8  8  8  8  3  8  8  8  8  8  1  1  1  1  3  0  0  0  0  0  0  0  0  8  8  8  8  8  8  
0  0  0  0  0  0  0  3  0  0  0  0  0  0  0  0  0  3  0  0  0  0  0  0  0  0  0  0  0  0  0  0  
0  0  0  0  0  0  0  3  0  0  0  0  0  4  0  0  7  3  0  0  0  0  0  0  22 0  0  0  0  0  0  0  
8  8  8  8  8  8  8  8  8  8  8  8  8  8  8  8  8  8  0  0  0  8  8  8  8  8  8  8  8  8  8  8  
