0  0  0  0  0  0  0  0  0  0  0  0  0  0  0  0  0  0  0  0  0  0  0  0  0  0  0  0  0  0  6  0  
0  0  0  0  0  0  0  0  0  0  0  0  0  0  0  0  0  0  0  0  0  0  0  0  0  0  0  0  0  0  0  0  
0  0  8  0  4  0  0  0  0  0  0  0  0  0  0  0  0  0  0  0  0  0  0  0  0  0  0  4  0  8  0  0  
0  0  8  8  8  8  8  8  3  0  22 0  0  0  0  0  0  0  0  0  0  0  22 0  3  8  8  8  8  8  0  0  
4  0  0  0  0  0  0  0  0  8  8  8  3  8  8  8  8  8  8  3  8  8  8  8  0  0  0  0  0  0  7  4  
1  1  1  1  0  0  0  0  0  0  0  0  3  0  0  0  0  0  0  3  0  0  0  0  0  0  0  0  1  1  1  1  
0  0  0  1  1  3  1  1  0  0  0  0  3  0  0  0  0  0  0  3  0  0  0  0  1  1  3  1  1  0  0  0  
0  0  0  0  0  3  0  1  1  1  1  0  3  4  0  0  0  0  4  3  0  1  1  1  1  0  3  0  0  0  0  0  
0  0  0  0  0  3  0  0  0  0  0  0  3  1  1  1  1  1  1  3  0  0  0  0  0  0  3  0  0  0  0  0  
8  8  8  8  8  8  8  8  8  8  8  8  3  0  0  0  0  0  0  3  8  8  8  8  8  8  8  8  8  8  8  8  
0  0  0  0  0  0  0  0  0  0  0  0  3  8  8  8  8  8  8  3  0  0  0  0  0  0  0  0  0  0  0  0  
0  0  0  0  4  0  0  0  0  0  0  0  3  0  0  0  0  0  0  3  0  0  0  0  0  0  0  4  0  0  0  0  
0  0  0  1  1  1  1  1  0  0  0  0  3  0  0  0  0  0  0  3  0  0  0  0  1  1  1  1  1  0  0  0  
0  0  0  0  0  0  0  0  0  22 0  3  8  8  8  8  8  8  8  8  3  0  22 0  0  0  0  0  0  0  0  0  
0  0  0  0  0  0  3  8  8  8  8  8  8  0  0  0  0  0  0  8  8  8  8  8  8  3  0  0  0  0  0  0  
0  0  0  0  4  0  3  0  0  0  0  0  0  0  0  0  0  0  0  0  0  0  0  0  0  3  0  4  0  0  0  0  
3  8  8  8  8  8  8  8  8  8  8  8  8  8  3  8  8  3  8  8  8  8  8  8  8  8  8  8  8  8  8  3  
3  0  0  0  0  0  0  0  0  0  0  0  0  0  3  23 0  3  0  0  0  0  0  0  0  0  0  0  0  0  0  3  
8  8  8  8  8  8  8  8  8  8  8  8  8  8  8  8  8  8  8  8  8  8  8  8  8  8  8  8  8  8  8  8  
