0  0  0  0  0  0  0  0  0  0  0  0  0  0  0  6  0  0  0  0  0  0  0  0  0  0  0  0  0  0  0  0  
0  0  0  0  0  0  4  0  0  0  0  0  0  0  0  7  0  0  0  0  0  0  0  4  0  0  0  0  0  0  0  0  
3  8  8  8  8  8  8  8  8  8  8  8  8  8  8  8  8  8  8  8  8  8  8  8  8  8  8  8  8  8  8  3  
3  0  0  0  0  0  0  0  0  0  0  0  0  0  4  0  0  0  4  0  0  0  0  0  0  0  0  0  0  0  0  3  
3  0  0  0  0  0  0  0  0  3  8  8  8  8  8  8  8  8  8  8  8  8  3  0  0  0  0  0  0  0  0  3  
3  0  0  0  0  4  0  0  0  3  0  0  0  0  0  0  0  0  0  0  0  0  3  0  0  0  4  0  0  0  0  3  
3  22 0  3  1  1  1  1  1  1  1  1  3  8  8  8  8  8  8  3  1  1  1  1  1  1  1  1  3  0  22 3  
8  8  8  8  0  0  0  0  0  0  0  0  3  0  0  0  0  0  0  3  0  0  0  0  0  0  0  0  8  8  8  8  
0  0  0  0  0  0  0  0  0  0  0  0  3  0  0  0  0  0  0  3  0  0  0  0  0  0  0  0  0  0  0  0  
0  4  0  2  2  2  2  0  0  0  0  0  3  0  0  0  0  0  0  3  0  0  0  0  0  2  2  2  2  0  4  0  
1  1  1  0  0  0  0  3  8  8  8  8  3  8  8  8  8  8  8  3  8  8  8  8  3  0  0  0  0  1  1  1  
0  0  0  0  0  0  3  8  0  0  0  0  3  0  0  0  0  0  0  3  0  0  0  0  8  3  0  0  0  0  0  0  
0  0  0  0  0  3  8  0  0  4  22 0  3  0  0  0  0  0  0  3  0  22 4  0  0  8  3  0  0  0  0  0  
0  0  0  0  3  8  8  8  8  8  8  8  3  8  8  8  8  8  8  3  8  8  8  8  8  8  8  3  0  0  0  0  
0  0  0  3  8  0  0  0  0  0  0  0  3  0  0  0  0  0  0  3  0  0  0  0  0  0  0  8  3  0  0  0  
0  0  3  8  0  0  0  0  0  4  0  0  3  0  0  0  0  0  0  3  0  0  0  0  4  0  0  0  8  3  0  0  
8  3  8  8  8  8  8  8  8  8  8  8  8  8  8  8  8  8  8  8  8  8  8  8  8  8  8  8  8  8  3  8  
0  3  0  0  0  0  0  0  0  0  0  0  0  0  0  23 0  0  0  0  0  0  0  0  0  0  0  0  0  0  3  0  
8  8  8  8  8  8  8  8  8  8  8  8  8  8  8  8  8  8  8  8  8  8  8  8  8  8  8  8  8  8  8  8  
